Please select Search Method: (B)readth, (U)niform, (G)reedy, or (A)*
or select (E)xit
B
    1    2    3    4    5    6    7    8    9   10   11    12
  ------------------------------------------------------------
1 | S ||   ||   |||||||   ||~~~||~~~||~~~||~~~||~~~||~~~||~~~|
  ------------------------------------------------------------
2 |   ||   ||   ||   ||   ||~~~||~~~||~~~||~~~||~~~||   ||   |
  ------------------------------------------------------------
3 |   |||||||   ||   ||||||||||||   ||||||||||||   ||   ||   |
  ------------------------------------------------------------
4 |   |||||||   ||   ||   ||||||||||||   ||   || G ||   ||   |
  ------------------------------------------------------------
5 |   |||||||   ||   ||   ||   ||   |||||||   ||   ||   ||   |
  ------------------------------------------------------------
6 |   |||||||~~~||~~~||   ||   ||   ||   ||||||||||||   ||   |
  ------------------------------------------------------------
7 |   ||   ||~~~||~~~||~~~||   ||   ||   || G |||||||   ||   |
  ------------------------------------------------------------
8 |~~~||~~~||~~~||~~~||~~~||   ||   ||   ||   ||   ||   ||   |
  ------------------------------------------------------------
9 |~~~||~~~||~~~||~~~||~~~||   ||   ||   ||   ||   ||   ||   |
  ------------------------------------------------------------
10|   ||   ||~~~||~~~||~~~||   ||   ||   ||   ||   ||   ||   |
  ------------------------------------------------------------
Breadth First
Nodes Explored: 537
Solution Length: 13
Total Cost: 17
(1,1)-->(1,2)-->(2,2)-->(3,2)-->(4,2)-->(5,2)-->(6,2)-->(7,2)-->(8,2)-->(9,2)-->(10,2)-->(10,3)-->(10,4)
Please select Search Method: (B)readth, (U)niform, (G)reedy, or (A)*
or select (E)xit
U
    1    2    3    4    5    6    7    8    9   10   11    12
  ------------------------------------------------------------
1 | S ||   ||   |||||||   ||~~~||~~~||~~~||~~~||~~~||~~~||~~~|
  ------------------------------------------------------------
2 |   ||   ||   ||   ||   ||~~~||~~~||~~~||~~~||~~~||   ||   |
  ------------------------------------------------------------
3 |   |||||||   ||   ||||||||||||   ||||||||||||   ||   ||   |
  ------------------------------------------------------------
4 |   |||||||   ||   ||   ||||||||||||   ||   || G ||   ||   |
  ------------------------------------------------------------
5 |   |||||||   ||   ||   ||   ||   |||||||   ||   ||   ||   |
  ------------------------------------------------------------
6 |   |||||||~~~||~~~||   ||   ||   ||   ||||||||||||   ||   |
  ------------------------------------------------------------
7 |   ||   ||~~~||~~~||~~~||   ||   ||   || G |||||||   ||   |
  ------------------------------------------------------------
8 |~~~||~~~||~~~||~~~||~~~||   ||   ||   ||   ||   ||   ||   |
  ------------------------------------------------------------
9 |~~~||~~~||~~~||~~~||~~~||   ||   ||   ||   ||   ||   ||   |
  ------------------------------------------------------------
10|   ||   ||~~~||~~~||~~~||   ||   ||   ||   ||   ||   ||   |
  ------------------------------------------------------------
Uniform Cost
Nodes Explored: 54
Solution Length: 15
Total Cost: 14
(1,1)-->(2,1)-->(3,1)-->(3,2)-->(3,3)-->(3,4)-->(4,4)-->(4,5)-->(5,5)-->(5,6)-->(6,6)-->(7,6)-->(7,7)-->(8,7)-->(9,7)
Please select Search Method: (B)readth, (U)niform, (G)reedy, or (A)*
or select (E)xit
G
    1    2    3    4    5    6    7    8    9   10   11    12
  ------------------------------------------------------------
1 | S ||   ||   |||||||   ||~~~||~~~||~~~||~~~||~~~||~~~||~~~|
  ------------------------------------------------------------
2 |   ||   ||   ||   ||   ||~~~||~~~||~~~||~~~||~~~||   ||   |
  ------------------------------------------------------------
3 |   |||||||   ||   ||||||||||||   ||||||||||||   ||   ||   |
  ------------------------------------------------------------
4 |   |||||||   ||   ||   ||||||||||||   ||   || G ||   ||   |
  ------------------------------------------------------------
5 |   |||||||   ||   ||   ||   ||   |||||||   ||   ||   ||   |
  ------------------------------------------------------------
6 |   |||||||~~~||~~~||   ||   ||   ||   ||||||||||||   ||   |
  ------------------------------------------------------------
7 |   ||   ||~~~||~~~||~~~||   ||   ||   || G |||||||   ||   |
  ------------------------------------------------------------
8 |~~~||~~~||~~~||~~~||~~~||   ||   ||   ||   ||   ||   ||   |
  ------------------------------------------------------------
9 |~~~||~~~||~~~||~~~||~~~||   ||   ||   ||   ||   ||   ||   |
  ------------------------------------------------------------
10|   ||   ||~~~||~~~||~~~||   ||   ||   ||   ||   ||   ||   |
  ------------------------------------------------------------
Greedy
Heuristic: The average of the Euclidean distance from the Node to the goal nodes
Nodes Explored: 13
Solution Length: 13
Total Cost: 17
(1,1)-->(2,1)-->(3,1)-->(3,2)-->(4,2)-->(5,2)-->(6,2)-->(7,2)-->(8,2)-->(9,2)-->(10,2)-->(10,3)-->(10,4)
Please select Search Method: (B)readth, (U)niform, (G)reedy, or (A)*
or select (E)xit
A
    1    2    3    4    5    6    7    8    9   10   11    12
  ------------------------------------------------------------
1 | S ||   ||   |||||||   ||~~~||~~~||~~~||~~~||~~~||~~~||~~~|
  ------------------------------------------------------------
2 |   ||   ||   ||   ||   ||~~~||~~~||~~~||~~~||~~~||   ||   |
  ------------------------------------------------------------
3 |   |||||||   ||   ||||||||||||   ||||||||||||   ||   ||   |
  ------------------------------------------------------------
4 |   |||||||   ||   ||   ||||||||||||   ||   || G ||   ||   |
  ------------------------------------------------------------
5 |   |||||||   ||   ||   ||   ||   |||||||   ||   ||   ||   |
  ------------------------------------------------------------
6 |   |||||||~~~||~~~||   ||   ||   ||   ||||||||||||   ||   |
  ------------------------------------------------------------
7 |   ||   ||~~~||~~~||~~~||   ||   ||   || G |||||||   ||   |
  ------------------------------------------------------------
8 |~~~||~~~||~~~||~~~||~~~||   ||   ||   ||   ||   ||   ||   |
  ------------------------------------------------------------
9 |~~~||~~~||~~~||~~~||~~~||   ||   ||   ||   ||   ||   ||   |
  ------------------------------------------------------------
10|   ||   ||~~~||~~~||~~~||   ||   ||   ||   ||   ||   ||   |
  ------------------------------------------------------------
A*
Heuristic: Greedy Cost + Uniform Cost Search
Nodes Explored: 39
Solution Length: 15
Total Cost: 14
(1,1)-->(2,1)-->(3,1)-->(3,2)-->(4,2)-->(4,3)-->(4,4)-->(5,4)-->(5,5)-->(6,5)-->(7,5)-->(7,6)-->(8,6)-->(8,7)-->(9,7)
Please select Search Method: (B)readth, (U)niform, (G)reedy, or (A)*
or select (E)xit
